F1 F1 F1 F1 F1 F1 G1 G1 R1 R1
F1 F1 F1 F1 F1 G1 G1 R1 R1 F1
F1 F1 F1 F1 G1 G1 R1 R1 G1 F1
F1 F1 F1 F1 G1 G1 R1 R1 G1 F1
F1 F1 G1 G1 F1 F1 R1 R1 G1 F1
F1 F1 F1 G1 F1 F1 R1 R1 G1 F1
F1 F1 R1 R1 R1 R1 R1 G1 G1 F1
F1 F1 R1 G1 G1 G1 G1 G1 F1 F1
F1 R1 R1 G1 G1 G1 F1 F1 F1 F1
R1 R1 G1 F1 F1 F1 F1 F1 F1 F1