| | | | | | , , . .
| | | | | , , . . |
| | | | , , . . , |
| | | | , , . . , |
| | ~ ~ | | . . , |
| | ~ ~ | | . . , |
| | . . . . . , , |
| | . , , , , , | |
| . . , , , | | | |
. . , | | | | | | |