F1 F1 F1 F1 F1 F1 G3 G2 GD R1
F1 F1 F1 F1 F1 G3 GD R1 R1 FA
F1 F1 F1 F1 G1 G9 R1 R1 GA F6
F1 F1 F1 F1 G1 G9 R1 R1 G5 F1
F1 F1 G1 G1 F1 F9 R1 R1 G5 F1
F1 F3 F2 G2 F2 FD R1 R1 G5 F1
F1 F9 R1 R1 R1 R1 R1 GA G6 F1
F3 FD R1 GA G7 G7 G7 G6 F1 F1
FD R1 R1 G5 G1 G1 F1 F1 F1 F1
R1 R1 GA F6 F1 F1 F1 F1 F1 F1
